benchmark,cache_size,fw_cluster_cache_hits,fw_cluster_cache_misses,fw_cluster_total,rev_cluster_cache_hits,rev_cluster_cache_misses,rev_cluster_total,fw_dram_access,rev_dram_access,total_dram_access,fw_cycles,rev_cycles,total_cycles,fw_bw(MB),rev_bw(MB),total_bw(MB),bin_zero_read_count,bin_zero_bw(MB)
mass_spring_ad_pure,1024,9304,2052,11356,0,0,0,2052,1332,3384,25987,60895,86882,505.5,140.0,249.3,0,0.0
mass_spring_ad_total,1024,9304,2052,11356,19945,2735,22680,2052,4067,6119,25987,60895,86882,505.5,427.6,450.9,0,0.0
mass_spring_ad_pure,2048,10320,1036,11356,0,0,0,1036,1332,2368,22897,58371,81268,289.6,146.1,186.5,0,0.0
mass_spring_ad_total,2048,10320,1036,11356,21045,1635,22680,1036,2967,4003,22897,58371,81268,289.6,325.4,315.3,0,0.0
mass_spring_ad_pure,4096,10823,533,11356,0,0,0,533,1332,1865,21272,55684,76956,160.4,153.1,155.2,0,0.0
mass_spring_ad_total,4096,10823,533,11356,21885,795,22680,533,2127,2660,21272,55684,76956,160.4,244.5,221.3,0,0.0
mass_spring_ad_pure,8192,10989,367,11356,0,0,0,367,1332,1699,20788,54292,75080,113.0,157.1,144.9,0,0.0
mass_spring_ad_total,8192,10989,367,11356,22309,371,22680,367,1703,2070,20788,54292,75080,113.0,200.8,176.5,0,0.0
mass_spring_ad_pure,16384,10992,364,11356,0,0,0,364,1332,1696,20781,54033,74814,112.1,157.8,145.1,0,0.0
mass_spring_ad_total,16384,10992,364,11356,22370,310,22680,364,1642,2006,20781,54033,74814,112.1,194.6,171.7,0,0.0
mass_spring_ad_pure,32768,10992,364,11356,0,0,0,364,1332,1696,20781,54033,74814,112.1,157.8,145.1,0,0.0
mass_spring_ad_total,32768,10992,364,11356,22371,309,22680,364,1641,2005,20781,54033,74814,112.1,194.4,171.6,0,0.0
mass_spring_ad_pure,65536,10992,364,11356,0,0,0,364,1332,1696,20781,54033,74814,112.1,157.8,145.1,0,0.0
mass_spring_ad_total,65536,10992,364,11356,22371,309,22680,364,1641,2005,20781,54033,74814,112.1,194.4,171.6,0,0.0
mass_spring_ad_pure,131072,10992,364,11356,0,0,0,364,1332,1696,20781,54033,74814,112.1,157.8,145.1,0,0.0
mass_spring_ad_total,131072,10992,364,11356,22371,309,22680,364,1641,2005,20781,54033,74814,112.1,194.4,171.6,0,0.0
mass_spring_ad_pure,262144,10992,364,11356,0,0,0,364,1332,1696,20781,54033,74814,112.1,157.8,145.1,0,0.0
mass_spring_ad_total,262144,10992,364,11356,22371,309,22680,364,1641,2005,20781,54033,74814,112.1,194.4,171.6,0,0.0
mass_spring_ad_pure,524288,10992,364,11356,0,0,0,364,1332,1696,20781,54033,74814,112.1,157.8,145.1,0,0.0
mass_spring_ad_total,524288,10992,364,11356,22371,309,22680,364,1641,2005,20781,54033,74814,112.1,194.4,171.6,0,0.0
mass_spring_ad_pure,1048576,10992,364,11356,0,0,0,364,1332,1696,20781,54033,74814,112.1,157.8,145.1,0,0.0
mass_spring_ad_total,1048576,10992,364,11356,22371,309,22680,364,1641,2005,20781,54033,74814,112.1,194.4,171.6,0,0.0
mass_spring_ad_pure,2097152,10992,364,11356,0,0,0,364,1332,1696,20781,54033,74814,112.1,157.8,145.1,0,0.0
mass_spring_ad_total,2097152,10992,364,11356,22371,309,22680,364,1641,2005,20781,54033,74814,112.1,194.4,171.6,0,0.0
mass_spring_orig_pure,1024,9247,8721,17968,19381,9911,29292,8721,9911,18632,49319,97063,146382,1131.9,653.6,814.7,0,0.0
mass_spring_orig_total,1024,9247,8721,17968,19381,9911,29292,8721,9911,18632,49319,97063,146382,1131.9,653.6,814.7,0,0.0
mass_spring_orig_pure,2048,11033,6935,17968,21686,7606,29292,6935,7606,14541,46278,90682,136960,959.2,536.9,679.6,0,0.0
mass_spring_orig_total,2048,11033,6935,17968,21686,7606,29292,6935,7606,14541,46278,90682,136960,959.2,536.9,679.6,0,0.0
mass_spring_orig_pure,4096,11712,6256,17968,22835,6457,29292,6256,6457,12713,44445,87377,131822,901.0,473.0,617.3,0,0.0
mass_spring_orig_total,4096,11712,6256,17968,22835,6457,29292,6256,6457,12713,44445,87377,131822,901.0,473.0,617.3,0,0.0
mass_spring_orig_pure,8192,11931,6037,17968,23449,5843,29292,6037,5843,11880,43527,85453,128980,887.8,437.7,589.6,0,0.0
mass_spring_orig_total,8192,11931,6037,17968,23449,5843,29292,6037,5843,11880,43527,85453,128980,887.8,437.7,589.6,0,0.0
mass_spring_orig_pure,16384,11993,5975,17968,23625,5667,29292,5975,5667,11642,42361,84617,126978,902.8,428.7,586.9,0,0.0
mass_spring_orig_total,16384,11993,5975,17968,23625,5667,29292,5975,5667,11642,42361,84617,126978,902.8,428.7,586.9,0,0.0
mass_spring_orig_pure,32768,13763,4205,17968,25382,3910,29292,4205,3910,8115,35450,77192,112642,759.3,324.2,461.2,0,0.0
mass_spring_orig_total,32768,13763,4205,17968,25382,3910,29292,4205,3910,8115,35450,77192,112642,759.3,324.2,461.2,0,0.0
mass_spring_orig_pure,65536,16309,1659,17968,28700,592,29292,1659,592,2251,30240,64860,95100,351.2,58.4,151.5,0,0.0
mass_spring_orig_total,65536,16309,1659,17968,28700,592,29292,1659,592,2251,30240,64860,95100,351.2,58.4,151.5,0,0.0
mass_spring_orig_pure,131072,16770,1198,17968,29100,192,29292,1198,192,1390,29215,63645,92860,262.5,19.3,95.8,0,0.0
mass_spring_orig_total,131072,16770,1198,17968,29100,192,29292,1198,192,1390,29215,63645,92860,262.5,19.3,95.8,0,0.0
mass_spring_orig_pure,262144,16770,1198,17968,29100,192,29292,1198,192,1390,29215,63645,92860,262.5,19.3,95.8,0,0.0
mass_spring_orig_total,262144,16770,1198,17968,29100,192,29292,1198,192,1390,29215,63645,92860,262.5,19.3,95.8,0,0.0